NO ./res/d_wall.xpm
SO ./res/d_wall.xpm
WE ./res/d_wall6.xpm
EA ./res/d_wall.xpm

F 200,225,204
C 222,243,246

111111111111
120000000011
10020000011
10000N00D11
10000000001
10000000001
10000000001
11111111111

11111111111
12000000001
10200000001
10000N00001
10000000001
10000000001
10000000001
11111111111
