NO ./res/d_wall.xpm
SO ./res/d_wall.xpm
WE ./res/d_wall.xpm
EA ./res/d_wall.xpm

F 220,100,0
C 225,30,0

        111
        101
        10
        101
        101
        101
        101
11111111101
1000N002001
11111111111
