NO ./res/d_wall.xpm
SO ./res/d_wall.xpm
WE ./res/d_wall.xpm
EA ./res/d_wall.xpm

F 200,225,204
C 222,243,246

11111111111
12000000001
10200000001
10000N00001
10000000001
10000000001
10000000001
11111111111
