1111111111111111
1000000100000001
100D000000000001
1100000N00000001
1000000000000001
1000000000200001
1000000000000001
1111111111111111