NO ./res/d_wall.xpm
SO ./res/d_wall.xpm
WE ./res/d_wall.xpm
EA ./res/d_wall.xpm

F 200,225,204
C 222,243,246

        111         111111111111
        101         100000000001
        101         100000000001
        101         100000000001
        101         111111111111
        101
        1D1
11111111101
1200N020001
11111111111
