1111111111111111
1000000100000001
1000000000000001
1000000N00000011
1000000000000001
1000000000200001
1000000000000001
1111111111111111