NO ./res/d_wall.xpm
SO ./res/d_wall.xpm
WE ./res/d_wall.xpm
EA ./res/d_wall.xpm

F 200,225,204
C 222,243,246

        111
        101
        101
        101
        101
        101
        1D1
11111111101
1200N020001
11111111111
