NO ./res/d_wall.xpm
SO ./res/4k-2.xpm
WE ./res/lava.xpm
EA ./res/4k.xpm

F 200,225,204
C 222,243,246

        1111111111111111111111111
        1000000000110000000000001
        1011000001110000000200001
        10010000000D0000000000001
111111111011000001110000000000001
1000000000D0000001110111111111111
11110111111111011100000010001
1111D111111111011101010010201
110000001101010111000000D0001
1000200000000000D000000010001
1000000000N000001101010010001
1100000111010101111101111000111
11110111 1110101 101111010001
11111111 1111111 111111111111
